1111111111111
10100000000C1
11C1011111011
1P1011E000011
1111111111111