1111111111111
10100000000C1
10C1011101111
1P0001E000011
1111111111111