111111111
101CPE111
111111111
111111111
111111111
111111111